40 52
5 3008
5 5 5 5 5 5 5 5 5 5 5 5 5 5 5 5 5 5 5 5 5 5 5 5 5 5 5 5 5 5 5 5 5 5 5 5 5 5 5 5
5 5 5 5 5 5 5 5 5 5 5 5 5 5 5 5 5 5 5 5 5 5 5 5 5 5 5 5 5 5 5 5 5 5 5 5 5 5 5 5
9 9 9 9 9 9 9 9 9 9 5 5 5 5 5 5 5 5 5 5 5 5 5 5 5 5 5 5 5 5 5 5 5 5 5 5 5 5 5 5
9 9 9 9 9 9 9 9 9 9 5 5 5 5 5 5 5 5 5 5 5 5 5 5 5 5 5 5 5 5 5 5 5 5 5 5 5 5 5 5
9 9 9 9 9 9 9 9 9 9 9 5 5 9 9 9 5 5 5 5 5 0 0 0 0 0 0 5 5 5 0 0 5 0 0 0 5 5 5 5
5 5 5 5 5 5 5 5 5 5 5 5 5 5 5 9 5 5 0 0 0 0 5 5 5 5 0 0 0 0 5 5 0 5 5 5 0 0 5 5
5 5 5 5 5 5 5 5 5 5 5 5 5 5 5 9 5 5 5 5 5 5 5 0 0 5 5 5 5 5 5 5 5 5 5 5 5 5 5 0
5 5 5 5 5 5 5 5 5 5 5 5 5 5 5 9 5 5 5 5 5 5 0 5 5 0 5 5 5 5 5 5 5 5 5 5 5 5 5 5
9 9 9 9 9 9 9 9 9 9 9 9 9 9 9 9 4 4 9 9 9 0 0 5 5 0 0 5 5 0 5 5 0 5 5 5 5 5 5 0
9 4 4 4 4 4 4 4 4 4 4 4 4 4 4 4 4 9 9 9 0 0 0 5 5 0 0 0 5 5 5 5 5 5 5 2 1 3 5 5
9 4 4 9 4 4 9 9 9 9 9 9 9 9 9 9 9 9 9 9 9 5 5 5 5 2 1 1 1 1 1 1 1 1 1 4 4 7 5 5
9 4 4 4 9 4 4 4 4 4 4 4 4 4 4 4 4 4 4 4 9 5 5 5 5 11 8 8 8 8 8 8 8 8 8 8 8 10 5 5
9 9 4 4 4 4 4 4 4 4 4 4 4 4 4 4 4 4 4 4 9 5 5 5 5 5 5 5 5 5 5 5 5 5 5 5 5 5 5 5
9 4 4 9 4 4 4 4 4 4 4 4 4 4 4 4 4 4 4 4 9 5 5 5 5 5 5 5 5 5 5 5 5 5 5 5 5 5 5 5
9 4 4 4 4 4 4 4 4 4 4 4 4 4 4 4 4 4 4 4 9 5 5 5 5 5 5 5 5 5 5 5 5 5 5 5 5 5 5 5
9 9 9 9 4 4 9 4 9 4 4 9 4 9 4 4 4 4 4 4 4 5 5 5 5 5 5 5 5 5 0 5 0 0 5 5 5 5 5 5
9 4 4 9 4 4 4 4 4 4 9 9 4 9 9 4 4 4 4 2 3 9 9 5 5 5 5 5 5 5 5 5 0 5 5 5 5 5 5 5
1 1 1 1 1 1 1 1 1 1 1 3 4 2 1 1 3 4 4 6 7 5 5 9 9 9 9 5 5 5 5 0 0 0 5 5 5 5 5 5
8 8 8 8 8 8 8 8 8 8 8 10 4 11 8 8 10 5 5 11 10 5 5 5 5 5 5 5 5 5 5 5 5 5 5 5 5 5 5 5
5 5 5 5 5 5 5 5 5 5 5 5 5 5 5 5 5 5 5 5 5 5 5 5 5 5 5 5 5 5 5 5 0 0 5 5 5 5 5 5
5 5 5 5 5 5 5 5 5 5 5 5 5 5 5 5 5 5 5 5 5 5 5 5 5 5 5 5 0 5 5 0 0 5 5 5 5 5 5 5
5 5 5 5 5 5 5 5 5 5 5 5 5 5 5 5 5 5 5 5 5 5 5 5 5 5 5 5 5 5 5 5 0 5 5 5 5 5 5 5
5 5 5 5 5 5 5 5 5 5 5 5 5 5 0 5 5 5 5 5 5 5 5 5 5 5 0 5 5 5 5 5 0 5 5 5 5 5 5 5
5 5 5 5 5 5 5 5 5 5 5 5 5 5 5 5 0 5 5 5 5 5 5 5 5 5 0 0 0 0 0 4 4 4 0 5 5 0 5 5
5 5 5 5 5 5 5 5 5 5 5 5 5 5 0 5 0 5 5 0 5 5 5 5 5 5 4 4 4 4 0 4 4 4 0 5 5 5 5 0
5 5 5 5 5 5 5 5 5 5 5 5 5 5 5 5 5 0 5 5 5 5 5 5 5 5 0 0 4 0 0 0 0 0 0 5 5 5 5 5
5 5 5 5 5 5 5 5 5 5 5 5 5 5 5 5 0 5 5 5 5 5 5 5 0 5 0 4 4 4 4 4 4 4 4 5 5 5 5 0
5 5 5 5 5 5 5 5 5 5 2 3 5 5 5 5 5 5 5 5 5 0 0 0 5 5 0 4 4 4 4 4 4 4 0 5 5 5 5 5
5 5 9 5 9 5 5 2 1 1 4 7 5 5 0 5 5 5 5 5 5 5 5 5 5 5 0 0 0 4 0 4 0 0 0 0 5 5 5 0
5 5 5 5 5 5 5 6 4 4 4 7 5 5 5 5 5 5 5 5 5 5 5 5 5 5 5 5 5 0 5 0 5 5 5 5 5 0 5 5
9 5 5 5 5 5 5 11 8 8 8 10 5 5 5 5 5 5 5 5 5 5 5 5 5 5 5 5 5 5 5 5 5 5 5 5 5 5 5 5
5 5 5 9 5 5 5 5 5 5 5 5 5 5 5 5 5 5 5 5 5 5 5 5 5 5 5 5 5 5 5 5 5 5 5 5 5 5 5 5
5 9 5 5 5 5 5 5 5 5 5 5 5 5 2 1 3 5 5 5 5 5 5 5 5 5 5 5 5 5 5 5 5 5 5 5 5 5 5 5
5 5 5 9 5 5 5 5 5 5 5 5 5 5 6 4 7 5 9 5 5 5 5 5 5 5 5 5 5 5 5 5 5 5 5 5 5 5 5 5
5 5 5 5 5 5 9 5 5 5 5 5 5 5 6 4 7 5 5 5 5 5 5 5 5 5 5 5 5 5 5 5 5 5 5 5 5 5 5 5
5 5 5 5 5 5 5 5 5 9 5 5 9 5 6 4 7 5 5 5 2 3 5 5 5 5 5 5 5 5 5 5 5 5 5 5 5 5 5 5
5 5 5 5 5 5 5 5 5 5 5 5 5 5 6 4 7 5 5 5 6 4 3 5 5 5 5 5 5 5 5 5 5 5 5 5 5 5 5 5
5 5 5 2 1 1 1 1 1 1 1 1 1 1 4 4 7 5 5 5 6 4 7 5 5 2 3 9 9 5 5 5 5 5 5 5 5 5 5 5
5 5 5 6 4 4 4 4 4 4 4 4 4 4 4 4 7 5 5 5 6 4 7 5 5 6 7 5 5 9 5 5 5 5 5 5 5 5 5 5
5 5 5 6 4 4 4 4 4 4 4 4 4 4 4 4 7 5 5 5 6 4 4 1 1 4 7 5 5 5 9 5 5 5 5 5 5 5 5 5
5 5 5 6 4 4 4 4 4 4 8 8 8 8 4 4 10 5 5 5 11 4 4 4 4 8 10 5 5 5 2 1 1 1 1 3 5 0 5 5
5 5 5 6 4 4 4 4 4 10 5 5 5 5 11 10 5 5 5 5 5 11 8 8 10 5 5 5 5 5 11 8 8 8 8 10 5 5 5 0
5 5 5 6 4 4 4 8 10 5 5 5 5 5 5 5 5 5 5 5 5 5 5 5 5 5 5 5 5 5 5 5 5 5 5 9 5 5 5 5
5 5 5 11 8 8 10 5 5 5 5 5 5 5 5 5 5 5 5 5 5 5 5 5 5 5 5 5 5 5 5 5 5 5 5 9 5 5 5 0
5 5 5 5 5 5 5 5 5 5 5 5 5 5 5 5 5 5 5 5 5 5 5 5 2 1 3 5 5 5 5 5 5 5 5 9 5 5 5 5
5 5 5 5 5 5 5 5 5 5 5 5 5 5 5 5 5 5 5 5 5 5 5 2 4 4 7 5 5 5 5 5 5 5 5 9 5 5 5 0
5 5 5 5 5 5 5 5 5 5 5 5 5 5 5 5 5 5 5 2 1 1 1 4 4 4 7 5 5 5 5 5 5 5 5 9 5 5 5 5
5 5 5 5 5 5 5 9 9 5 5 5 5 5 5 2 3 5 5 6 4 4 4 4 4 4 7 5 5 5 2 1 1 4 1 3 5 5 5 0
5 5 5 5 5 5 5 5 5 5 5 5 5 5 2 4 7 5 5 6 4 4 4 4 4 4 7 5 5 5 6 4 4 4 4 7 5 5 5 5
1 1 1 1 1 1 1 1 1 1 3 5 5 2 4 4 7 5 5 6 4 4 4 4 4 4 7 5 5 5 6 4 4 4 4 4 5 5 0 5
4 4 4 4 4 4 4 4 4 4 7 5 5 6 4 4 7 5 5 6 4 4 4 4 4 4 7 5 5 5 2 1 3 4 2 1 3 5 5 5
4 4 4 4 4 4 4 4 4 4 7 5 5 6 4 4 7 5 5 6 4 4 4 4 4 4 7 5 5 5 11 8 8 1 8 8 10 5 5 5